R 1024 768
NO ./xpm/north_texture.xpm
SO ./xpm/south_texture.xpm
WE ./xpm/west_texture.xpm
EA ./xpm/east_texture.xpm

S ./xpm/barrel.xpm
F ./xpm/wood_floor.xpm
C ./xpm/ceiling.xpm

        0111111111111111111111111111
        1000000020001100000000011
        111E0000011100000000000101
        1001110000000000000000000011
111111111011000001110000000000001001
10000000001100000111011111111111 111
11110111111111011100000010001
11110111111111011101010010001
11000000110101011100000010001
10002000000000001100000010001
10000000000000001101010010001
1100000111010101111101111000101
11110111 1110101 101111010001
11111111 1111111 101111111111
